{
  "width": 16,
  "height": 8,
  "nextLevel": "2",
  "mapping": {
    "floor": 0,
    "grass": 1,
    "hole": 2,
    "wall": 3,
    "stairs": 4
  },
  "characters": [
    {
      "x": 2,
      "y": 2,
      "id": "player"
    },
    {
      "x": 3,
      "y": 2,
      "id": "sheep"
    },
    {
      "x": 5,
      "y": 2,
      "id": "sheep"
    }
  ],
  "tiles": [
    3, 3, 3, 3, 3, 3, 3, 3, 3, 3, 3, 3, 3, 3, 3, 3,
    3, 1, 1, 1, 3, 0, 0, 0, 0, 0, 0, 3, 0, 0, 2, 3,
    3, 1, 1, 1, 3, 0, 3, 3, 0, 0, 0, 3, 0, 0, 0, 3,
    3, 1, 0, 0, 3, 0, 3, 0, 0, 2, 0, 0, 0, 0, 0, 3,
    3, 0, 0, 0, 0, 0, 0, 0, 2, 2, 0, 0, 0, 1, 1, 3,
    3, 2, 0, 0, 0, 0, 2, 2, 2, 2, 2, 0, 1, 1, 1, 3,
    3, 2, 2, 0, 0, 0, 0, 0, 0, 0, 0, 0, 1, 1, 4, 3,
    3, 3, 3, 3, 3, 3, 3, 3, 3, 3, 3, 3, 3, 3, 3, 3
  ]
}